XXXXXXXXXXXXX
XFXXXXXXXXXXX
XFXXXXXXXXXXX
XFXXXXXXXXXXX
XFFFFXXXXXXXX
XXXFXXXXXXXXX
XXXFXXXXXXXXX
XXXFXXXXXXXXX
XXXFXXXXXXXXX
XXXFXXXXXXXXX
XXXFXXXXXXXXX
XFFFXXXXXXXXX
XXXXXXXXXXXXX